Tm,Player,Rk,Pos,Age,G,GS,MP,FG,FGA,FG%,3P,3PA,3P%,2P,2PA,2P%,eFG%,FT,FTA,FT%,ORB,DRB,TRB,AST,STL,BLK,TOV,PF,PTS
ATL,DeAndre' Bembry,40,SF,22,38,1,371,47,98,0.48,1,18,0.056,46,80,0.575,0.485,6,16,0.375,14,45,59,28,8,5,16,21,101
ATL,Dennis Schroder,394,PG,23,79,78,2485,548,1214,0.451,100,294,0.34,448,920,0.487,0.493,218,255,0.855,42,206,248,499,74,16,258,149,1414
ATL,Dwight Howard,205,C,31,74,74,2199,388,613,0.633,0,2,0.0,388,611,0.635,0.633,226,424,0.5329999999999999,296,644,940,104,64,92,170,203,1002
ATL,Edy Tavares,418,C,24,1,0,4,1,1,1.0,0,0,,1,1,1.0,1.0,0,2,0.0,0,1,1,0,0,0,0,0,2
ATL,Gary Neal,323,SG,32,2,0,18,0,7,0.0,0,2,0.0,0,5,0.0,0.0,4,4,1.0,0,1,1,1,0,0,0,1,4
ATL,Kent Bazemore,35,SF,27,73,64,1963,295,721,0.409,92,266,0.34600000000000003,203,455,0.446,0.473,119,168,0.708,45,186,231,177,91,52,125,165,801
ATL,Kris Humphries,208,PF,31,56,4,689,87,214,0.407,19,54,0.35200000000000004,68,160,0.425,0.451,64,82,0.78,60,146,206,29,15,21,28,69,257
ATL,Kyle Korver,248,SG,35,32,21,894,108,246,0.439,65,159,0.409,43,87,0.494,0.5710000000000001,24,27,0.889,0,89,89,75,23,13,40,47,305
ATL,Lamar Patterson,349,SG,25,5,0,40,3,15,0.2,1,6,0.16699999999999998,2,9,0.222,0.233,2,3,0.667,1,6,7,6,1,0,4,6,9
ATL,Malcolm Delaney,105,PG,27,73,2,1248,145,388,0.374,26,110,0.236,119,278,0.428,0.407,75,93,0.8059999999999999,10,113,123,193,39,1,95,112,391
ATL,Mike Muscala,319,C,25,70,3,1237,170,337,0.504,46,110,0.418,124,227,0.546,0.573,49,64,0.7659999999999999,76,164,240,95,30,41,55,97,435
ATL,Mike Scott,396,PF,28,18,0,195,17,59,0.28800000000000003,4,27,0.14800000000000002,13,32,0.406,0.322,7,8,0.875,10,27,37,17,4,3,8,12,45
ATL,Paul Millsap,306,PF,31,69,67,2343,430,972,0.442,75,241,0.311,355,731,0.486,0.481,311,405,0.768,111,422,533,252,90,62,158,186,1246
ATL,Ryan Kelly,244,PF,25,16,0,110,8,28,0.28600000000000003,4,10,0.4,4,18,0.222,0.35700000000000004,5,6,0.833,1,17,18,8,4,5,4,5,25
ATL,Taurean Waller-Prince,453,SF,22,59,10,981,114,285,0.4,33,102,0.324,81,183,0.443,0.458,74,94,0.787,25,132,157,55,43,27,61,96,335
ATL,Thabo Sefolosha,397,SF,32,62,42,1596,174,395,0.441,41,120,0.342,133,275,0.484,0.4920000000000001,55,75,0.733,54,216,270,107,96,31,58,97,444
ATL,Tim Hardaway,171,SG,24,79,30,2154,415,912,0.455,149,417,0.35700000000000004,266,495,0.537,0.537,164,214,0.7659999999999999,35,189,224,182,55,15,106,103,1143
BOS,Al Horford,203,C,30,68,68,2193,379,801,0.473,86,242,0.355,293,559,0.524,0.527,108,135,0.8,95,370,465,337,52,86,115,138,952
BOS,Amir Johnson,226,PF,29,80,77,1608,213,370,0.5760000000000001,27,66,0.409,186,304,0.612,0.612,67,100,0.67,118,248,366,140,51,62,77,211,520
BOS,Avery Bradley,55,SG,26,55,55,1835,359,775,0.463,108,277,0.39,251,498,0.504,0.5329999999999999,68,93,0.731,65,269,334,122,68,11,88,141,894
BOS,Demetrius Jackson,217,PG,22,5,0,17,3,4,0.75,1,1,1.0,2,3,0.667,0.875,3,6,0.5,2,2,4,3,0,0,0,0,10
BOS,Gerald Green,165,SF,31,47,0,538,95,232,0.409,39,111,0.35100000000000003,56,121,0.463,0.494,33,41,0.805,16,68,84,33,9,7,25,48,262
BOS,Isaiah Thomas,424,PG,27,76,76,2569,682,1473,0.463,245,646,0.379,437,827,0.528,0.546,590,649,0.909,43,162,205,448,70,13,210,167,2199
BOS,Jae Crowder,95,SF,26,72,72,2335,333,720,0.463,157,394,0.398,176,326,0.54,0.5720000000000001,176,217,0.8109999999999999,48,367,415,155,73,23,80,161,999
BOS,James Young,478,SG,21,29,0,220,25,58,0.431,12,35,0.343,13,23,0.565,0.534,6,9,0.667,6,20,26,4,10,2,4,15,68
BOS,Jaylen Brown,61,SF,20,78,20,1341,192,423,0.454,46,135,0.341,146,288,0.507,0.508,85,124,0.685,45,175,220,64,35,18,68,142,515
BOS,Jonas Jerebko,225,PF,29,78,6,1232,114,262,0.435,45,130,0.34600000000000003,69,132,0.523,0.521,26,37,0.703,59,213,272,71,25,17,39,122,299
BOS,Jordan Mickey,300,PF,22,25,1,141,15,34,0.441,0,1,0.0,15,33,0.455,0.441,8,14,0.5710000000000001,13,21,34,7,3,6,9,12,38
BOS,Kelly Olynyk,340,C,25,75,6,1538,260,508,0.512,68,192,0.354,192,316,0.608,0.579,90,123,0.732,73,288,361,148,43,29,96,207,678
BOS,Marcus Smart,405,SG,22,79,24,2399,269,749,0.359,94,332,0.28300000000000003,175,417,0.42,0.422,203,250,0.812,78,227,305,364,125,34,159,192,835
BOS,Terry Rozier,385,PG,22,74,0,1263,151,411,0.3670000000000001,57,179,0.318,94,232,0.405,0.4370000000000001,51,66,0.773,40,187,227,131,46,11,47,69,410
BOS,Tyler Zeller,483,C,27,51,5,525,78,158,0.494,0,1,0.0,78,157,0.4970000000000001,0.494,22,39,0.564,43,81,124,42,7,21,20,61,178
BRK,Anthony Bennett,42,PF,23,23,1,264,38,92,0.413,13,48,0.271,25,44,0.568,0.484,26,36,0.722,25,53,78,12,5,3,12,18,115
BRK,Bojan Bogdanovic,50,SF,27,55,54,1482,269,611,0.44,99,277,0.35700000000000004,170,334,0.509,0.521,146,167,0.8740000000000001,23,174,197,90,24,3,93,99,783
BRK,Brook Lopez,271,C,28,75,75,2222,555,1172,0.474,134,387,0.34600000000000003,421,785,0.536,0.531,295,364,0.81,121,282,403,176,38,124,184,192,1539
BRK,Caris LeVert,264,SF,22,57,26,1237,171,380,0.45,59,184,0.321,112,196,0.5710000000000001,0.528,67,93,0.72,23,165,188,110,49,8,59,91,468
BRK,Chris McCullough,290,PF,21,14,0,72,16,31,0.516,1,6,0.16699999999999998,15,25,0.6,0.532,2,3,0.667,9,8,17,2,1,2,2,7,35
BRK,Greivis Vasquez,444,PG,30,3,0,39,2,8,0.25,1,3,0.333,1,5,0.2,0.313,2,3,0.667,0,2,2,5,1,1,1,6,7
BRK,Isaiah Whitehead,460,PG,21,73,26,1643,204,508,0.402,44,149,0.295,160,359,0.446,0.445,91,113,0.805,32,152,184,192,42,36,142,175,543
BRK,Jeremy Lin,267,PG,28,36,33,883,175,400,0.438,58,156,0.3720000000000001,117,244,0.48,0.51,115,141,0.816,11,124,135,184,42,14,86,79,523
BRK,Joe Harris,178,SG,25,52,11,1138,154,362,0.425,85,221,0.385,69,141,0.489,0.5429999999999999,35,49,0.7140000000000001,16,131,147,54,30,8,55,121,428
BRK,Justin Hamilton,169,C,26,64,7,1177,174,379,0.459,55,180,0.306,119,199,0.598,0.532,39,52,0.75,71,191,262,55,29,43,43,91,442
BRK,Luis Scola,395,PF,36,36,1,461,71,151,0.47,17,50,0.34,54,101,0.535,0.526,25,37,0.6759999999999999,51,88,139,37,14,4,34,63,184
BRK,Randy Foye,139,SG,33,69,40,1284,118,325,0.363,67,203,0.33,51,122,0.418,0.466,54,63,0.857,9,146,155,135,35,9,80,99,357
BRK,Rondae Hollis-Jefferson,200,SF,22,78,50,1761,235,542,0.434,15,67,0.224,220,475,0.463,0.447,190,253,0.7509999999999999,96,356,452,154,82,44,116,177,675
BRK,Sean Kilpatrick,246,SG,27,70,24,1754,305,735,0.415,105,308,0.341,200,427,0.468,0.486,204,242,0.843,22,258,280,157,45,6,135,118,919
BRK,Spencer Dinwiddie,112,PG,23,59,18,1334,134,302,0.444,38,101,0.376,96,201,0.478,0.507,126,159,0.792,27,137,164,185,44,23,66,119,432
BRK,Trevor Booker,54,PF,29,71,43,1754,305,591,0.516,25,78,0.321,280,513,0.546,0.537,74,110,0.6729999999999999,143,428,571,138,75,28,127,152,709
BRK,Yogi Ferrell,135,PG,23,10,0,151,18,49,0.3670000000000001,8,27,0.29600000000000004,10,22,0.455,0.449,10,16,0.625,4,8,12,17,2,2,14,11,54
CHI,Bobby Portis,362,PF,21,64,13,1000,183,375,0.488,32,96,0.333,151,279,0.541,0.531,39,59,0.6609999999999999,75,221,296,35,16,11,37,94,437
CHI,Cristiano Felicio,133,C,24,66,0,1040,128,221,0.579,0,0,,128,221,0.579,0.579,60,93,0.645,124,187,311,40,25,17,33,110,316
CHI,Denzel Valentine,441,SG,23,57,0,976,102,288,0.354,73,208,0.35100000000000003,29,80,0.363,0.481,14,18,0.778,11,140,151,63,30,7,49,86,291
CHI,Doug McDermott,292,SF,25,44,4,1078,166,373,0.445,56,150,0.373,110,223,0.493,0.52,59,67,0.8809999999999999,14,116,130,45,11,4,32,57,447
CHI,Dwyane Wade,449,SG,35,60,59,1792,414,955,0.434,45,145,0.31,369,810,0.456,0.457,223,281,0.794,63,207,270,228,86,41,138,112,1096
CHI,Isaiah Canaan,70,SG,25,39,0,592,63,173,0.364,25,94,0.266,38,79,0.481,0.436,30,33,0.909,6,44,50,37,22,1,21,35,181
CHI,Jerian Grant,162,PG,24,63,28,1028,128,301,0.425,49,134,0.366,79,167,0.473,0.507,65,73,0.89,17,94,111,121,47,8,44,93,370
CHI,Jimmy Butler,66,SF,27,76,75,2809,570,1252,0.455,91,248,0.3670000000000001,479,1004,0.477,0.4920000000000001,585,676,0.865,129,341,470,417,143,32,159,112,1816
CHI,Michael Carter-Williams,74,PG,25,45,19,846,112,306,0.366,15,64,0.234,97,242,0.401,0.391,58,77,0.753,24,129,153,113,38,23,66,102,297
CHI,Nikola Mirotic,307,PF,25,70,15,1679,258,625,0.413,129,377,0.342,129,248,0.52,0.516,99,128,0.773,61,323,384,75,53,55,80,128,744
CHI,Paul Zipser,485,SF,22,44,18,843,88,221,0.398,33,99,0.333,55,122,0.451,0.473,31,40,0.775,15,110,125,36,15,16,40,78,240
CHI,R.J. Hunter,209,SG,23,3,0,9,0,1,0.0,0,1,0.0,0,0,,0.0,0,0,,0,1,1,0,0,0,0,0,0
CHI,Rajon Rondo,382,PG,30,69,42,1843,229,561,0.408,50,133,0.376,179,428,0.418,0.453,30,50,0.6,73,282,355,461,99,11,169,144,538
CHI,Robin Lopez,272,C,28,81,81,2271,382,775,0.493,0,2,0.0,382,773,0.494,0.493,75,104,0.721,244,276,520,80,18,117,91,151,839
CHI,Taj Gibson,153,PF,31,55,55,1502,276,530,0.521,2,12,0.16699999999999998,274,518,0.529,0.523,85,119,0.7140000000000001,120,262,382,60,27,50,77,123,639
CHO,Aaron Harrison,181,SG,22,5,0,17,0,4,0.0,0,2,0.0,0,2,0.0,0.0,1,2,0.5,0,3,3,3,0,0,0,2,1
CHO,Brian Roberts,378,PG,31,41,2,416,46,122,0.377,17,44,0.386,29,78,0.3720000000000001,0.447,33,39,0.846,5,34,39,52,9,1,26,18,142
CHO,Christian Wood,474,PF,21,13,0,107,12,23,0.522,0,5,0.0,12,18,0.667,0.522,11,15,0.733,14,15,29,2,3,6,7,11,35
CHO,Cody Zeller,482,C,24,62,58,1725,253,443,0.5710000000000001,0,1,0.0,253,442,0.5720000000000001,0.5710000000000001,133,196,0.679,135,270,405,99,62,58,65,189,639
CHO,Frank Kaminsky,242,C,23,75,16,1954,320,802,0.399,116,354,0.328,204,448,0.455,0.471,118,156,0.7559999999999999,57,279,336,162,46,34,76,139,874
CHO,Jeremy Lamb,252,SG,24,62,5,1143,226,491,0.46,41,146,0.281,185,345,0.536,0.502,110,129,0.853,30,234,264,75,27,23,40,98,603
CHO,Kemba Walker,451,PG,26,79,79,2739,643,1449,0.444,240,602,0.399,403,847,0.476,0.527,304,359,0.847,45,263,308,434,85,22,168,119,1830
CHO,Marco Belinelli,39,SG,30,74,0,1778,264,615,0.429,102,283,0.36,162,332,0.488,0.512,150,168,0.893,14,164,178,147,44,9,70,90,780
CHO,Marvin Williams,468,PF,30,76,76,2295,297,704,0.422,124,354,0.35,173,350,0.494,0.51,131,150,0.873,89,411,500,106,58,53,60,134,849
CHO,Michael Kidd-Gilchrist,245,SF,23,81,81,2349,295,618,0.477,1,9,0.111,294,609,0.483,0.478,152,194,0.784,156,409,565,114,81,77,56,187,743
CHO,Mike Tobey,430,C,22,2,0,25,1,4,0.25,0,0,,1,4,0.25,0.25,0,0,,2,1,3,1,0,0,1,2,2
CHO,Nicolas Batum,32,SG,28,77,77,2617,393,975,0.403,135,405,0.333,258,570,0.453,0.472,243,284,0.856,46,435,481,456,86,29,194,109,1164
CHO,Ramon Sessions,400,PG,30,50,1,811,100,263,0.38,21,62,0.339,79,201,0.393,0.42,91,118,0.7709999999999999,11,62,73,129,27,3,46,43,312
CHO,Roy Hibbert,191,C,30,42,13,671,78,144,0.542,0,0,,78,144,0.542,0.542,61,75,0.813,53,97,150,20,8,44,31,97,217
CHO,Spencer Hawes,184,PF,28,35,1,626,104,218,0.477,16,55,0.29100000000000004,88,163,0.54,0.514,30,34,0.882,32,114,146,62,13,26,40,61,254
CHO,Treveon Graham,160,SG,23,27,1,189,19,40,0.475,9,15,0.6,10,25,0.4,0.588,10,15,0.667,5,17,22,6,6,1,3,18,57
CLE,Channing Frye,141,C,33,74,15,1398,238,520,0.458,137,335,0.409,101,185,0.546,0.589,63,74,0.851,37,253,290,45,33,37,53,138,676
CLE,Chris Andersen,11,C,38,12,0,114,9,22,0.409,0,3,0.0,9,19,0.474,0.409,10,14,0.7140000000000001,9,22,31,5,5,7,5,20,28
CLE,Dahntay Jones,234,SF,36,1,0,12,3,8,0.375,0,2,0.0,3,6,0.5,0.375,3,4,0.75,1,1,2,1,0,0,1,1,9
CLE,DeAndre Liggins,265,SG,28,61,19,752,52,136,0.382,17,45,0.378,35,91,0.385,0.445,23,37,0.622,17,84,101,54,45,14,42,78,144
CLE,Iman Shumpert,401,SG,26,76,31,1937,201,489,0.411,94,261,0.36,107,228,0.469,0.507,71,90,0.789,39,179,218,109,62,27,78,150,567
CLE,J.R. Smith,407,SG,31,41,35,1187,123,356,0.34600000000000003,95,271,0.35100000000000003,28,85,0.329,0.479,10,15,0.667,17,96,113,62,40,11,26,77,351
CLE,James Jones,237,SF,36,48,2,381,44,92,0.478,31,66,0.47,13,26,0.5,0.647,13,20,0.65,3,34,37,14,6,10,10,37,132
CLE,Jordan McRae,296,SG,25,37,4,384,58,150,0.387,18,51,0.353,40,99,0.404,0.447,27,34,0.794,6,35,41,19,8,6,14,31,161
CLE,Kay Felder,132,PG,21,42,0,386,62,158,0.392,7,22,0.318,55,136,0.404,0.415,35,49,0.7140000000000001,3,38,41,58,18,7,30,38,166
CLE,Kevin Love,273,PF,28,60,60,1885,370,867,0.4270000000000001,145,389,0.373,225,478,0.471,0.51,257,295,0.871,148,518,666,116,53,21,122,125,1142
CLE,Kyrie Irving,215,PG,24,72,72,2525,671,1420,0.473,177,441,0.401,494,979,0.505,0.535,297,328,0.905,52,178,230,418,83,24,180,157,1816
CLE,Larry Sanders,391,C,28,5,0,13,1,4,0.25,0,0,,1,4,0.25,0.25,2,2,1.0,3,1,4,0,1,1,2,5,4
CLE,LeBron James,220,SF,32,74,74,2794,736,1344,0.5479999999999999,124,342,0.363,612,1002,0.611,0.594,358,531,0.674,97,542,639,646,92,44,303,134,1954
CLE,Mike Dunleavy,117,SF,36,23,2,366,36,90,0.4,20,57,0.35100000000000003,16,33,0.485,0.511,14,19,0.737,5,42,47,20,6,2,14,32,106
CLE,Richard Jefferson,222,SF,36,79,13,1614,153,343,0.446,62,186,0.333,91,157,0.58,0.536,80,108,0.741,28,175,203,78,26,10,52,153,448
CLE,Tristan Thompson,428,C,25,78,78,2336,262,437,0.6,0,3,0.0,262,434,0.604,0.6,106,213,0.498,286,429,715,77,39,84,64,176,630
DAL,A.J. Hammons,170,C,24,22,0,163,17,42,0.405,5,10,0.5,12,32,0.375,0.464,9,20,0.45,8,28,36,4,1,13,10,21,48
DAL,Andrew Bogut,51,C,32,26,21,582,38,81,0.469,0,1,0.0,38,80,0.475,0.469,3,11,0.273,56,162,218,49,13,25,43,84,79
DAL,Ben Bentil,43,PF,21,3,0,10,0,3,0.0,0,1,0.0,0,2,0.0,0.0,0,0,,0,2,2,0,0,0,1,1,0
DAL,Deron Williams,465,PG,32,40,40,1171,195,453,0.43,63,181,0.348,132,272,0.485,0.5,69,84,0.821,13,89,102,274,25,2,98,96,522
DAL,Devin Harris,176,PG,33,65,0,1087,136,341,0.399,58,177,0.328,78,164,0.476,0.484,107,129,0.8290000000000001,11,116,127,136,43,7,57,101,437
DAL,Dirk Nowitzki,332,PF,38,54,54,1424,296,678,0.4370000000000001,79,209,0.378,217,469,0.463,0.495,98,112,0.875,23,330,353,82,30,38,51,113,769
DAL,Dorian Finney-Smith,136,PF,23,81,35,1642,124,333,0.3720000000000001,56,191,0.293,68,142,0.479,0.456,46,61,0.754,55,167,222,67,52,25,45,125,350
DAL,Dwight Powell,364,C,25,77,3,1333,194,377,0.515,21,74,0.284,173,303,0.5710000000000001,0.542,107,141,0.759,93,213,306,49,61,39,34,135,516
DAL,Harrison Barnes,28,PF,24,79,79,2803,599,1280,0.468,78,222,0.35100000000000003,521,1058,0.4920000000000001,0.498,242,281,0.861,93,301,394,116,65,15,102,128,1518
DAL,J.J. Barea,27,PG,32,35,6,771,142,343,0.414,53,148,0.358,89,195,0.456,0.491,44,51,0.863,9,75,84,193,14,1,63,30,381
DAL,Jarrod Uthoff,439,PF,23,9,0,115,16,38,0.421,3,9,0.333,13,29,0.448,0.461,5,7,0.7140000000000001,8,14,22,9,2,4,3,8,40
DAL,Jonathan Gibson,152,PG,29,17,0,231,35,95,0.368,15,45,0.333,20,50,0.4,0.447,21,29,0.7240000000000001,1,21,22,26,8,0,21,21,106
DAL,Justin Anderson,13,SF,23,51,2,710,111,277,0.401,37,122,0.303,74,155,0.477,0.468,70,88,0.795,39,110,149,32,28,16,40,64,329
DAL,Manny Harris,179,SG,27,4,0,25,3,15,0.2,0,2,0.0,3,13,0.231,0.2,2,4,0.5,3,6,9,2,0,0,2,1,8
DAL,Nicolas Brussino,62,SG,23,54,2,521,52,141,0.369,29,95,0.305,23,46,0.5,0.472,17,22,0.773,26,69,95,47,17,8,26,43,150
DAL,Pierre Jackson,218,PG,25,8,1,84,13,39,0.333,3,11,0.273,10,28,0.35700000000000004,0.3720000000000001,6,7,0.857,1,8,9,19,2,0,3,5,35
DAL,Quincy Acy,2,PF,26,6,0,48,5,17,0.294,1,7,0.14300000000000002,4,10,0.4,0.324,2,3,0.667,2,6,8,0,0,0,2,9,13
DAL,Quinn Cook,89,PG,23,5,0,77,11,25,0.44,5,14,0.35700000000000004,6,11,0.545,0.54,0,2,0.0,0,3,3,12,1,0,8,6,27
DAL,Salah Mejri,299,C,30,73,11,905,88,137,0.642,1,3,0.333,87,134,0.649,0.6459999999999999,36,61,0.59,97,211,308,14,32,61,40,152,213
DAL,Seth Curry,97,PG,26,70,42,2029,338,703,0.481,137,322,0.425,201,381,0.528,0.578,85,100,0.85,25,154,179,189,79,7,92,126,898
DAL,Wesley Matthews,284,SG,30,73,73,2495,333,847,0.393,174,479,0.363,159,368,0.4320000000000001,0.496,146,179,0.816,18,241,259,210,77,15,102,161,986
DEN,Alonzo Gee,149,SF,29,13,0,89,3,14,0.214,0,3,0.0,3,11,0.273,0.214,5,9,0.556,4,11,15,6,5,1,4,14,11
DEN,Danilo Gallinari,142,SF,28,63,63,2134,335,750,0.447,126,324,0.389,209,426,0.491,0.531,349,387,0.902,39,286,325,135,40,15,82,93,1145
DEN,Darrell Arthur,20,PF,28,41,7,639,95,215,0.442,53,117,0.453,42,98,0.429,0.565,19,22,0.8640000000000001,25,87,112,42,19,21,36,76,262
DEN,Emmanuel Mudiay,315,PG,20,55,41,1406,208,551,0.377,56,178,0.315,152,373,0.408,0.428,131,167,0.784,29,149,178,217,41,13,123,95,603
DEN,Gary Harris,177,SG,22,57,56,1782,320,637,0.502,107,255,0.42,213,382,0.5579999999999999,0.586,104,134,0.7759999999999999,48,130,178,164,71,8,76,92,851
DEN,Jamal Murray,318,SG,19,82,10,1764,295,730,0.404,115,344,0.334,180,386,0.466,0.483,106,120,0.883,41,173,214,170,51,24,113,124,811
DEN,Jameer Nelson,324,PG,34,75,39,2045,268,604,0.444,106,273,0.388,162,331,0.489,0.531,45,63,0.7140000000000001,28,164,192,385,54,8,128,197,687
DEN,Jarnell Stokes,414,C,23,2,0,7,1,1,1.0,0,0,,1,1,1.0,1.0,1,2,0.5,1,1,2,2,1,0,0,3,3
DEN,Johnny O'Bryant,335,PF,23,7,0,46,7,15,0.467,2,3,0.667,5,12,0.417,0.5329999999999999,4,4,1.0,5,6,11,2,0,1,3,4,20
DEN,Juan Hernangomez,188,PF,21,62,9,842,101,224,0.451,46,113,0.407,55,111,0.495,0.5539999999999999,57,76,0.75,43,144,187,29,30,12,31,62,305
DEN,Jusuf Nurkic,333,C,22,45,29,807,151,298,0.507,0,0,,151,298,0.507,0.507,56,113,0.496,89,171,260,60,25,36,81,88,358
DEN,Kenneth Faried,129,PF,27,61,34,1296,228,416,0.5479999999999999,0,6,0.0,228,410,0.556,0.5479999999999999,131,189,0.693,183,279,462,55,43,40,59,124,587
DEN,Malik Beasley,37,SG,20,22,1,165,33,73,0.452,9,28,0.321,24,45,0.5329999999999999,0.514,8,10,0.8,5,12,17,11,7,0,8,10,83
DEN,Mike Miller,303,SF,36,20,0,151,9,23,0.391,8,20,0.4,1,3,0.333,0.565,2,2,1.0,2,36,38,22,2,0,13,9,28
DEN,Nikola Jokic,233,C,21,73,59,2038,494,854,0.578,45,139,0.324,449,715,0.628,0.605,188,228,0.825,212,506,718,359,61,55,171,214,1221
DEN,Will Barton,30,SG,26,60,19,1705,295,666,0.443,87,235,0.37,208,431,0.483,0.508,143,190,0.753,58,201,259,206,48,28,97,110,820
DEN,Wilson Chandler,78,SF,29,71,33,2197,433,939,0.461,110,326,0.337,323,613,0.527,0.52,141,194,0.727,103,357,460,141,51,30,114,172,1117
DET,Andre Drummond,115,C,23,81,81,2409,483,911,0.53,2,7,0.28600000000000003,481,904,0.532,0.531,137,355,0.386,345,770,1115,90,124,89,152,237,1105
DET,Aron Baynes,34,C,30,75,2,1163,143,279,0.513,0,0,,143,279,0.513,0.513,79,94,0.84,111,222,333,32,17,39,50,166,365
DET,Beno Udrih,437,PG,34,39,0,560,92,197,0.467,11,32,0.344,81,165,0.491,0.495,32,34,0.941,6,51,57,131,13,0,36,29,227
DET,Boban Marjanovic,282,C,28,35,0,293,72,132,0.545,0,0,,72,132,0.545,0.545,47,58,0.81,46,84,130,9,6,12,10,25,191
DET,Darrun Hilliard,197,SG,23,39,1,381,47,126,0.373,12,46,0.261,35,80,0.438,0.421,21,28,0.75,2,31,33,33,11,2,28,39,127
DET,Henry Ellenson,121,PF,20,19,2,146,23,64,0.359,10,35,0.28600000000000003,13,29,0.448,0.438,4,8,0.5,8,33,41,7,1,1,14,6,60
DET,Ish Smith,406,PG,28,81,32,1955,329,749,0.439,28,105,0.267,301,644,0.467,0.458,72,102,0.706,21,214,235,418,61,33,112,127,758
DET,Jon Leuer,263,PF,27,75,34,1944,310,646,0.48,49,167,0.293,261,479,0.545,0.518,98,113,0.867,102,300,402,111,31,26,66,145,767
DET,Kentavious Caldwell-Pope,69,SG,23,76,75,2529,370,928,0.399,153,437,0.35,217,491,0.442,0.481,154,185,0.8320000000000001,55,193,248,193,89,12,86,118,1047
DET,Marcus Morris,310,SF,27,79,79,2565,421,1007,0.418,118,357,0.331,303,650,0.466,0.477,145,185,0.784,77,289,366,160,52,25,87,168,1105
DET,Michael Gbinije,148,SG,24,9,0,32,1,10,0.1,0,4,0.0,1,6,0.16699999999999998,0.1,2,2,1.0,2,1,3,2,0,0,0,2,4
DET,Reggie Bullock,63,SF,25,31,5,467,54,128,0.422,28,73,0.384,26,55,0.473,0.531,5,7,0.7140000000000001,13,51,64,29,18,3,10,22,141
DET,Reggie Jackson,219,PG,26,52,50,1424,284,677,0.419,66,184,0.359,218,493,0.442,0.468,118,136,0.868,21,93,114,270,35,5,114,129,752
DET,Stanley Johnson,230,SF,20,77,1,1371,129,365,0.353,45,154,0.292,84,211,0.398,0.415,36,53,0.679,36,153,189,105,56,24,71,121,339
DET,Tobias Harris,180,PF,24,82,48,2567,511,1063,0.481,109,314,0.34700000000000003,402,749,0.537,0.532,190,226,0.841,63,353,416,142,60,39,96,133,1321
GSW,Anderson Varejao,443,C,34,14,1,92,5,14,0.35700000000000004,0,0,,5,14,0.35700000000000004,0.35700000000000004,8,11,0.727,12,15,27,10,3,3,8,16,18
GSW,Andre Iguodala,211,SF,33,76,0,1998,219,415,0.528,64,177,0.362,155,238,0.6509999999999999,0.605,72,102,0.706,51,253,304,261,76,39,58,97,574
GSW,Briante Weber,456,PG,24,7,0,46,5,14,0.35700000000000004,0,3,0.0,5,11,0.455,0.35700000000000004,2,3,0.667,0,4,4,5,3,1,3,4,12
GSW,Damian Jones,235,C,21,10,0,85,8,16,0.5,0,0,,8,16,0.5,0.5,3,10,0.3,9,14,23,0,1,4,6,15,19
GSW,David West,457,C,36,68,0,854,135,252,0.536,3,8,0.375,132,244,0.541,0.542,43,56,0.768,47,156,203,151,42,48,78,105,316
GSW,Draymond Green,164,PF,26,76,76,2471,272,650,0.418,81,263,0.308,191,387,0.494,0.481,151,213,0.7090000000000001,98,501,599,533,154,106,184,217,776
GSW,Ian Clark,82,SG,25,77,0,1137,211,433,0.487,61,163,0.374,150,270,0.556,0.5579999999999999,44,58,0.759,22,99,121,90,39,8,55,77,527
GSW,JaVale McGee,293,C,29,77,10,739,208,319,0.652,0,3,0.0,208,316,0.6579999999999999,0.652,56,111,0.505,100,144,244,17,19,67,40,109,472
GSW,James Michael McAdoo,286,PF,24,52,2,457,62,117,0.53,2,8,0.25,60,109,0.55,0.5379999999999999,21,42,0.5,34,57,91,18,18,29,19,47,147
GSW,Kevin Durant,119,PF,28,62,62,2070,551,1026,0.537,117,312,0.375,434,714,0.608,0.594,336,384,0.875,39,474,513,300,66,99,138,117,1555
GSW,Kevon Looney,270,C,20,53,4,447,56,107,0.523,2,9,0.222,54,98,0.551,0.5329999999999999,21,34,0.618,44,80,124,29,15,17,17,64,135
GSW,Klay Thompson,427,SG,26,78,78,2649,644,1376,0.468,268,647,0.414,376,729,0.516,0.565,186,218,0.853,49,236,285,160,66,40,128,139,1742
GSW,Patrick McCaw,287,SG,21,71,20,1074,106,245,0.433,41,123,0.333,65,122,0.5329999999999999,0.516,29,37,0.784,21,79,100,77,32,15,36,62,282
GSW,Shaun Livingston,268,PG,31,76,3,1345,173,316,0.547,1,3,0.333,172,313,0.55,0.5489999999999999,42,60,0.7,28,123,151,139,38,20,62,120,389
GSW,Stephen Curry,98,PG,28,79,79,2638,675,1443,0.468,324,789,0.411,351,654,0.537,0.58,325,362,0.898,61,292,353,524,142,17,239,183,1999
GSW,Zaza Pachulia,344,C,32,70,70,1268,164,307,0.534,0,2,0.0,164,305,0.5379999999999999,0.534,98,126,0.778,140,270,410,132,59,33,87,166,426
HOU,Bobby Brown,60,PG,32,25,0,123,23,60,0.383,14,35,0.4,9,25,0.36,0.5,2,2,1.0,0,6,6,14,1,0,5,5,62
HOU,Chinanu Onuaku,342,C,20,5,1,52,5,7,0.7140000000000001,0,0,,5,7,0.7140000000000001,0.7140000000000001,4,4,1.0,2,8,10,3,3,1,4,6,14
HOU,Clint Capela,71,C,22,65,59,1551,362,563,0.643,0,0,,362,563,0.643,0.643,94,177,0.531,178,348,526,63,34,79,87,179,818
HOU,Corey Brewer,56,SF,30,58,8,923,94,227,0.414,22,94,0.234,72,133,0.541,0.463,32,44,0.727,21,93,114,61,37,12,36,104,242
HOU,Eric Gordon,158,SG,28,75,15,2323,412,1016,0.406,246,661,0.3720000000000001,166,355,0.468,0.527,147,175,0.84,29,172,201,188,48,41,121,150,1217
HOU,Isaiah Taylor,419,PG,22,4,0,52,1,7,0.14300000000000002,0,2,0.0,1,5,0.2,0.14300000000000002,1,2,0.5,1,2,3,3,1,1,0,6,3
HOU,James Harden,172,PG,27,81,81,2947,674,1533,0.44,262,756,0.34700000000000003,412,777,0.53,0.525,746,881,0.847,95,564,659,907,121,38,464,215,2356
HOU,K.J. McDaniels,291,SF,23,29,0,212,31,68,0.456,9,27,0.333,22,41,0.537,0.522,9,10,0.9,6,24,30,4,7,8,10,24,80
HOU,Kyle Wiltjer,471,PF,24,14,0,44,4,14,0.28600000000000003,4,13,0.308,0,1,0.0,0.429,1,2,0.5,4,6,10,2,3,1,5,4,13
HOU,Montrezl Harrell,175,C,23,58,14,1064,225,345,0.652,1,7,0.14300000000000002,224,338,0.6629999999999999,0.654,76,121,0.628,81,138,219,64,20,42,44,126,527
HOU,Nene Hilario,193,C,34,67,8,1198,245,397,0.617,3,9,0.333,242,388,0.624,0.621,116,197,0.589,95,187,282,65,56,39,73,163,609
HOU,Patrick Beverley,45,SG,28,67,67,2058,228,543,0.42,110,288,0.382,118,255,0.463,0.521,73,95,0.768,95,298,393,281,99,25,100,222,639
HOU,Ryan Anderson,15,PF,28,72,72,2116,323,773,0.418,204,506,0.403,119,267,0.446,0.55,129,150,0.86,112,218,330,68,31,14,55,142,979
HOU,Sam Dekker,104,PF,22,77,2,1419,203,429,0.473,60,187,0.321,143,242,0.591,0.5429999999999999,38,68,0.5589999999999999,94,190,284,76,38,21,41,83,504
HOU,Trevor Ariza,19,SF,31,80,80,2773,326,798,0.409,191,555,0.344,135,243,0.556,0.528,93,126,0.738,54,404,458,175,147,20,73,133,936
HOU,Tyler Ennis,126,PG,22,31,0,196,25,64,0.391,6,16,0.375,19,48,0.396,0.438,2,3,0.667,4,15,19,34,6,0,24,29,58
IND,Aaron Brooks,58,PG,32,65,0,894,121,300,0.403,48,128,0.375,73,172,0.424,0.483,32,40,0.8,18,51,69,125,25,9,66,93,322
IND,Al Jefferson,221,C,32,66,1,931,235,471,0.499,0,1,0.0,235,470,0.5,0.499,65,85,0.765,75,203,278,57,19,16,33,125,535
IND,C.J. Miles,302,SF,29,76,29,1776,281,647,0.434,169,409,0.413,112,238,0.471,0.565,84,93,0.903,30,199,229,48,46,25,40,151,815
IND,Georges Niang,326,PF,23,23,0,93,9,36,0.25,1,12,0.083,8,24,0.333,0.264,2,2,1.0,2,15,17,5,3,0,5,6,21
IND,Glenn Robinson,379,SF,23,69,27,1427,158,338,0.467,49,125,0.392,109,213,0.512,0.54,54,76,0.711,57,189,246,47,41,20,37,63,419
IND,Jeff Teague,420,PG,28,82,82,2657,402,909,0.442,90,252,0.35700000000000004,312,657,0.475,0.4920000000000001,360,415,0.867,33,297,330,639,100,32,216,165,1254
IND,Joe Young,479,PG,24,33,0,135,26,72,0.361,5,23,0.217,21,49,0.429,0.396,11,15,0.733,1,16,17,15,4,0,5,5,68
IND,Kevin Seraphin,399,PF,27,49,3,559,109,198,0.551,0,2,0.0,109,196,0.556,0.551,14,22,0.636,41,101,142,23,7,20,29,66,232
IND,Lavoy Allen,8,PF,27,61,5,871,77,168,0.458,0,1,0.0,77,167,0.461,0.458,23,33,0.6970000000000001,105,114,219,57,18,24,29,78,177
IND,Monta Ellis,123,SG,31,74,33,1998,247,557,0.443,43,135,0.319,204,422,0.483,0.482,93,128,0.727,19,185,204,236,78,27,135,149,630
IND,Myles Turner,436,C,20,81,81,2541,444,869,0.511,40,115,0.348,404,754,0.536,0.534,245,303,0.809,139,450,589,106,74,172,105,262,1173
IND,Paul George,150,SF,26,75,75,2689,622,1348,0.461,195,496,0.393,427,852,0.501,0.534,336,374,0.898,58,434,492,251,119,27,220,206,1775
IND,Rakeem Christmas,80,PF,25,29,0,219,19,43,0.442,0,0,,19,43,0.442,0.442,21,29,0.7240000000000001,26,30,56,4,3,6,8,37,59
IND,Rodney Stuckey,416,PG,30,39,0,696,91,244,0.373,19,60,0.317,72,184,0.391,0.412,80,107,0.748,6,78,84,84,16,0,53,44,281
IND,Thaddeus Young,481,PF,28,74,74,2237,362,687,0.527,45,118,0.381,317,569,0.557,0.56,45,86,0.523,131,317,448,122,113,29,95,135,814
LAC,Alan Anderson,12,SF,34,30,0,308,30,80,0.375,14,44,0.318,16,36,0.444,0.463,12,16,0.75,3,21,24,11,3,0,7,35,86
LAC,Austin Rivers,376,SG,24,74,29,2054,323,731,0.442,111,299,0.371,212,432,0.491,0.518,132,191,0.691,20,141,161,204,48,10,115,187,889
LAC,Blake Griffin,168,PF,27,61,61,2076,479,971,0.493,38,113,0.336,441,858,0.514,0.513,320,421,0.76,112,385,497,300,57,22,142,157,1316
LAC,Brandon Bass,31,PF,31,52,0,577,107,186,0.575,1,3,0.333,106,183,0.579,0.578,77,88,0.875,43,86,129,21,14,11,29,45,292
LAC,Brice Johnson,227,PF,22,3,0,9,2,7,0.28600000000000003,0,0,,2,7,0.28600000000000003,0.28600000000000003,0,0,,1,2,3,1,2,1,1,0,4
LAC,Chris Paul,351,PG,31,61,61,1921,374,785,0.476,124,302,0.411,250,483,0.518,0.555,232,260,0.892,40,264,304,563,119,8,147,146,1104
LAC,DeAndre Jordan,240,C,28,81,81,2570,412,577,0.7140000000000001,0,2,0.0,412,575,0.7170000000000001,0.7140000000000001,205,425,0.482,298,816,1114,96,51,134,115,212,1029
LAC,Diamond Stone,415,C,19,7,0,24,3,13,0.231,0,0,,3,13,0.231,0.231,4,4,1.0,1,5,6,0,0,1,2,5,10
LAC,J.J. Redick,372,SG,32,78,78,2198,396,890,0.445,201,468,0.429,195,422,0.462,0.5579999999999999,180,202,0.8909999999999999,11,160,171,110,54,13,98,125,1173
LAC,Jamal Crawford,93,SG,36,82,1,2157,359,870,0.413,116,322,0.36,243,548,0.443,0.479,174,203,0.857,17,112,129,214,61,14,134,115,1008
LAC,Luc Mbah a Moute,285,SF,30,80,76,1787,191,378,0.505,43,110,0.391,148,268,0.552,0.562,59,87,0.6779999999999999,44,126,170,39,81,35,46,122,484
LAC,Marreese Speights,410,C,29,82,2,1286,244,548,0.445,103,277,0.3720000000000001,141,271,0.52,0.539,120,137,0.8759999999999999,88,285,373,65,23,41,69,229,711
LAC,Paul Pierce,356,SF,39,25,7,277,28,70,0.4,15,43,0.349,13,27,0.481,0.507,10,13,0.769,1,47,48,10,4,5,16,40,81
LAC,Raymond Felton,134,PG,32,80,11,1700,221,514,0.43,46,144,0.319,175,370,0.473,0.475,50,64,0.7809999999999999,33,185,218,191,66,22,83,125,538
LAC,Wesley Johnson,232,SF,29,68,3,810,73,200,0.365,29,118,0.246,44,82,0.537,0.438,11,17,0.647,26,155,181,23,29,30,18,83,186
LAL,Brandon Ingram,214,SF,19,79,40,2279,276,686,0.402,55,187,0.294,221,499,0.443,0.442,133,214,0.621,60,256,316,166,50,36,116,158,740
LAL,D'Angelo Russell,389,PG,20,63,60,1811,351,867,0.405,135,384,0.35200000000000004,216,483,0.447,0.483,147,188,0.782,31,190,221,303,87,16,176,130,984
LAL,David Nwaba,334,SG,24,20,2,397,47,81,0.58,1,5,0.2,46,76,0.605,0.586,25,39,0.6409999999999999,17,46,63,14,13,7,11,36,120
LAL,Ivica Zubac,486,C,19,38,11,609,126,238,0.529,0,3,0.0,126,235,0.536,0.529,32,49,0.653,41,118,159,30,14,33,30,66,284
LAL,Jordan Clarkson,83,SG,24,82,19,2397,477,1071,0.445,117,356,0.329,360,715,0.503,0.5,134,168,0.7979999999999999,49,197,246,213,88,8,164,150,1205
LAL,Jose Calderon,68,PG,35,24,11,292,32,77,0.416,12,34,0.353,20,43,0.465,0.494,4,4,1.0,8,34,42,51,7,1,26,22,80
LAL,Julius Randle,370,PF,22,74,73,2132,377,773,0.488,17,63,0.27,360,710,0.507,0.499,204,282,0.723,150,486,636,264,49,37,173,248,975
LAL,Larry Nance,320,PF,24,63,7,1442,190,361,0.526,10,36,0.278,180,325,0.5539999999999999,0.54,59,80,0.738,120,249,369,96,82,39,56,149,449
LAL,Lou Williams,467,SG,30,58,1,1403,326,734,0.444,122,317,0.385,204,417,0.489,0.527,304,344,0.884,14,118,132,183,65,11,120,67,1078
LAL,Luol Deng,107,SF,31,56,49,1486,164,424,0.387,51,165,0.309,113,259,0.436,0.447,46,63,0.73,63,232,295,74,48,20,43,61,425
LAL,Marcelo Huertas,206,PG,33,23,1,237,25,68,0.368,4,19,0.211,21,49,0.429,0.397,9,17,0.529,2,22,24,52,10,2,19,16,63
LAL,Metta World Peace,475,SF,37,25,2,160,19,68,0.279,9,38,0.237,10,30,0.333,0.34600000000000003,10,16,0.625,5,15,20,11,10,2,7,18,57
LAL,Nick Young,480,SG,31,60,60,1556,272,633,0.43,170,421,0.404,102,212,0.481,0.564,77,90,0.856,25,113,138,58,37,14,36,137,791
LAL,Tarik Black,48,C,25,67,16,1091,150,294,0.51,1,2,0.5,149,292,0.51,0.512,82,109,0.752,144,199,343,39,29,44,58,173,383
LAL,Thomas Robinson,380,PF,25,48,1,560,105,196,0.536,0,1,0.0,105,195,0.5379999999999999,0.536,31,66,0.47,84,139,223,31,26,9,46,76,241
LAL,Timofey Mozgov,314,C,30,54,52,1104,169,328,0.515,0,1,0.0,169,327,0.517,0.515,63,78,0.8079999999999999,104,160,264,43,16,31,72,133,401
MEM,Andrew Harrison,182,PG,22,72,18,1474,117,360,0.325,43,156,0.276,74,204,0.363,0.385,148,194,0.763,23,113,136,198,53,21,85,194,425
MEM,Brandan Wright,476,PF,29,28,5,447,83,135,0.615,0,1,0.0,83,134,0.619,0.615,23,35,0.657,31,47,78,15,11,20,10,42,189
MEM,Chandler Parsons,348,SF,28,34,34,675,75,222,0.338,25,93,0.269,50,129,0.388,0.394,35,43,0.8140000000000001,6,78,84,55,20,5,24,52,210
MEM,Deyonta Davis,101,C,20,36,0,238,24,47,0.511,0,0,,24,47,0.511,0.511,10,18,0.556,20,40,60,2,3,17,8,40,58
MEM,JaMychal Green,166,PF,26,77,75,2101,250,500,0.5,55,145,0.379,195,355,0.5489999999999999,0.555,134,167,0.802,167,377,544,84,47,34,94,248,689
MEM,James Ennis,125,SF,26,64,28,1501,146,321,0.455,51,137,0.3720000000000001,95,184,0.516,0.534,86,110,0.782,69,190,259,64,46,19,59,165,429
MEM,Jarell Martin,283,PF,22,42,3,558,58,151,0.384,9,25,0.36,49,126,0.389,0.414,40,50,0.8,42,120,162,8,17,9,28,91,165
MEM,Marc Gasol,145,C,32,74,74,2531,532,1160,0.459,104,268,0.388,428,892,0.48,0.503,278,332,0.8370000000000001,60,404,464,338,67,99,166,171,1446
MEM,Mike Conley,87,PG,29,69,68,2292,464,1009,0.46,171,419,0.408,293,590,0.4970000000000001,0.545,316,368,0.8590000000000001,31,210,241,433,92,19,156,126,1415
MEM,Toney Douglas,113,PG,30,24,0,394,43,117,0.368,7,42,0.16699999999999998,36,75,0.48,0.397,24,29,0.828,13,48,61,56,18,5,21,50,117
MEM,Tony Allen,9,SG,35,71,66,1914,274,595,0.461,15,54,0.278,259,541,0.479,0.473,80,130,0.615,166,225,391,98,115,29,100,178,643
MEM,Troy Daniels,99,SG,25,67,3,1183,185,495,0.374,138,355,0.389,47,140,0.336,0.513,43,54,0.7959999999999999,22,78,100,46,20,4,45,90,551
MEM,Troy Williams,470,SF,22,24,13,418,51,123,0.415,10,41,0.244,41,82,0.5,0.455,15,25,0.6,6,39,45,19,24,9,26,42,127
MEM,Vince Carter,73,SF,40,73,15,1799,193,490,0.394,112,296,0.378,81,194,0.418,0.508,88,115,0.765,36,191,227,133,60,36,50,163,586
MEM,Wade Baldwin,25,PG,20,33,1,405,36,115,0.313,3,22,0.136,33,93,0.355,0.326,31,37,0.838,11,35,46,61,18,7,39,40,106
MEM,Zach Randolph,371,PF,35,73,5,1786,433,964,0.449,21,94,0.223,412,870,0.474,0.46,141,193,0.731,182,416,598,122,38,10,99,136,1028
MIA,Derrick Williams,466,PF,25,25,11,377,54,137,0.394,9,45,0.2,45,92,0.489,0.4270000000000001,31,50,0.62,16,57,73,14,9,5,14,33,148
MIA,Dion Waiters,450,SG,25,46,43,1384,281,663,0.424,85,215,0.395,196,448,0.438,0.488,82,127,0.6459999999999999,18,135,153,200,42,20,103,95,729
MIA,Goran Dragic,114,PG,30,73,73,2459,534,1124,0.475,117,289,0.405,417,835,0.499,0.527,298,377,0.79,62,217,279,423,89,13,212,199,1483
MIA,Hassan Whiteside,461,C,27,77,77,2513,542,973,0.557,0,0,,542,973,0.557,0.557,225,358,0.628,293,795,1088,57,57,161,154,226,1309
MIA,James Johnson,228,PF,29,76,5,2085,368,769,0.479,87,256,0.34,281,513,0.5479999999999999,0.535,152,215,0.7070000000000001,66,310,376,276,76,86,171,197,975
MIA,Josh McRoberts,297,PF,29,22,14,381,44,118,0.373,13,31,0.419,31,87,0.35600000000000004,0.428,6,9,0.667,23,51,74,50,10,4,23,31,107
MIA,Josh Richardson,374,SG,23,53,34,1614,202,513,0.394,75,227,0.33,127,286,0.444,0.467,60,77,0.779,35,133,168,140,60,39,65,132,539
MIA,Justise Winslow,472,SF,20,18,15,625,80,225,0.35600000000000004,7,35,0.2,73,190,0.384,0.371,29,47,0.617,23,71,94,66,26,6,33,52,196
MIA,Luke Babbitt,23,SF,27,68,55,1065,113,281,0.402,87,210,0.414,26,71,0.366,0.557,11,15,0.733,12,129,141,36,20,11,25,118,324
MIA,Okaro White,459,PF,24,35,0,471,33,87,0.379,12,34,0.353,21,53,0.396,0.448,20,22,0.909,25,57,82,21,10,10,18,52,98
MIA,Rodney McGruder,294,SG,25,78,65,1966,190,460,0.413,73,220,0.332,117,240,0.488,0.4920000000000001,44,71,0.62,94,162,256,124,46,18,56,140,497
MIA,Tyler Johnson,231,PG,24,73,0,2178,357,824,0.433,93,250,0.3720000000000001,264,574,0.46,0.49,195,254,0.768,50,243,293,233,84,44,90,176,1002
MIA,Udonis Haslem,183,C,36,16,0,130,11,23,0.478,0,3,0.0,11,20,0.55,0.478,9,15,0.6,8,28,36,6,6,1,8,22,31
MIA,Wayne Ellington,122,SG,29,62,13,1500,231,555,0.416,149,394,0.378,82,161,0.509,0.55,37,43,0.86,18,114,132,70,35,4,30,70,648
MIA,Willie Reed,373,C,26,71,5,1031,162,285,0.568,1,4,0.25,161,281,0.573,0.57,49,88,0.557,129,203,332,26,18,47,31,137,374
MIL,Axel Toupane,432,SF,24,2,0,6,0,1,0.0,0,1,0.0,0,0,,0.0,0,0,,0,0,0,0,0,0,0,1,0
MIL,Gary Payton,355,PG,24,6,0,99,8,22,0.364,1,9,0.111,7,13,0.5379999999999999,0.386,3,5,0.6,0,12,12,13,3,4,10,9,20
MIL,Giannis Antetokounmpo,16,SF,22,80,80,2845,656,1259,0.521,49,180,0.272,607,1079,0.563,0.541,471,612,0.77,142,558,700,434,131,151,234,246,1832
MIL,Greg Monroe,308,C,26,81,0,1823,387,726,0.5329999999999999,0,4,0.0,387,722,0.536,0.5329999999999999,177,239,0.741,167,365,532,187,92,38,140,168,951
MIL,Jabari Parker,346,PF,21,51,50,1728,399,814,0.49,65,178,0.365,334,636,0.525,0.53,162,218,0.743,79,235,314,142,50,22,93,111,1025
MIL,Jason Terry,423,SG,39,74,0,1365,105,243,0.4320000000000001,73,171,0.4270000000000001,32,72,0.444,0.5820000000000001,24,29,0.828,15,91,106,98,46,20,36,95,307
MIL,John Henson,187,C,26,58,39,1123,159,309,0.515,0,1,0.0,159,308,0.516,0.515,74,107,0.6920000000000001,92,203,295,57,29,78,52,151,392
MIL,Khris Middleton,301,SF,25,29,23,889,150,333,0.45,45,104,0.433,105,229,0.459,0.518,81,92,0.88,11,112,123,99,41,7,65,79,426
MIL,Malcolm Brogdon,57,SG,24,75,28,1982,290,635,0.457,78,193,0.404,212,442,0.48,0.518,109,126,0.865,47,166,213,317,84,12,113,140,767
MIL,Matthew Dellavedova,106,PG,26,76,54,1986,208,534,0.39,79,215,0.3670000000000001,129,319,0.404,0.463,82,96,0.8540000000000001,24,123,147,357,53,0,133,153,577
MIL,Michael Beasley,38,PF,28,56,6,935,216,406,0.532,18,43,0.419,198,363,0.545,0.5539999999999999,78,105,0.743,40,153,193,53,27,27,66,92,528
MIL,Miles Plumlee,359,C,28,32,12,310,30,68,0.441,0,0,,30,68,0.441,0.441,22,35,0.629,23,30,53,18,11,9,22,48,82
MIL,Mirza Teletovic,421,PF,31,70,2,1133,156,418,0.373,104,305,0.341,52,113,0.46,0.498,35,45,0.778,11,151,162,48,12,13,37,109,451
MIL,Rashad Vaughn,445,SG,20,41,2,458,57,156,0.365,26,81,0.321,31,75,0.413,0.449,2,5,0.4,4,45,49,23,19,10,14,32,142
MIL,Steve Novak,331,PF,33,8,0,22,2,7,0.28600000000000003,1,6,0.16699999999999998,1,1,1.0,0.35700000000000004,0,0,,0,3,3,0,0,0,0,1,5
MIL,Thon Maker,281,C,19,57,34,562,83,181,0.459,28,74,0.378,55,107,0.514,0.536,32,49,0.653,40,74,114,23,10,26,17,84,226
MIL,Tony Snell,409,SG,25,80,80,2336,246,541,0.455,144,355,0.406,102,186,0.5479999999999999,0.588,47,58,0.81,22,226,248,96,55,14,55,125,683
MIN,Adreian Payne,352,PF,25,18,0,135,23,54,0.426,3,15,0.2,20,39,0.513,0.454,14,19,0.737,9,24,33,7,8,7,8,32,63
MIN,Andrew Wiggins,462,SF,21,82,82,3048,709,1570,0.452,103,289,0.35600000000000004,606,1281,0.473,0.484,412,542,0.76,102,226,328,189,82,30,187,183,1933
MIN,Brandon Rush,388,SG,31,47,33,1030,70,187,0.374,44,114,0.386,26,73,0.35600000000000004,0.4920000000000001,13,18,0.722,16,83,99,45,22,23,28,42,197
MIN,Cole Aldrich,6,C,28,62,0,531,45,86,0.523,0,0,,45,86,0.523,0.523,15,22,0.682,51,107,158,25,25,23,17,85,105
MIN,Gorgui Dieng,111,PF,27,82,82,2653,332,661,0.502,16,43,0.3720000000000001,316,618,0.511,0.514,136,167,0.8140000000000001,188,459,647,158,88,95,107,254,816
MIN,John Lucas III,275,PG,34,5,0,11,1,4,0.25,0,1,0.0,1,3,0.333,0.25,0,0,,0,0,0,1,2,0,0,0,2
MIN,Jordan Hill,195,C,29,7,0,47,5,13,0.385,0,0,,5,13,0.385,0.385,2,2,1.0,8,6,14,0,1,0,4,9,12
MIN,Karl-Anthony Towns,433,C,21,82,82,3030,802,1480,0.542,101,275,0.3670000000000001,701,1205,0.5820000000000001,0.5760000000000001,356,428,0.8320000000000001,296,711,1007,220,56,103,212,241,2061
MIN,Kris Dunn,118,PG,22,78,7,1333,118,313,0.377,21,73,0.28800000000000003,97,240,0.404,0.411,36,59,0.61,24,142,166,188,78,36,89,178,293
MIN,Nemanja Bjelica,47,PF,28,65,1,1190,151,356,0.424,56,177,0.316,95,179,0.531,0.503,45,61,0.738,57,187,244,79,40,20,59,154,403
MIN,Ricky Rubio,386,PG,26,75,75,2469,261,650,0.402,60,196,0.306,201,454,0.443,0.448,254,285,0.8909999999999999,68,237,305,682,128,10,195,202,836
MIN,Shabazz Muhammad,316,SF,24,78,1,1516,288,598,0.482,49,145,0.338,239,453,0.528,0.523,147,190,0.774,84,136,220,35,22,6,56,86,772
MIN,Tyus Jones,239,PG,20,60,0,774,75,181,0.414,26,73,0.35600000000000004,49,108,0.454,0.486,33,43,0.767,10,57,67,156,48,5,38,50,209
MIN,Zach LaVine,255,SG,21,47,47,1749,326,710,0.459,120,310,0.387,206,400,0.515,0.544,117,140,0.836,19,141,160,139,41,10,85,104,889
NOP,Alexis Ajinca,5,C,28,39,15,584,89,178,0.5,0,4,0.0,89,174,0.511,0.5,29,40,0.725,46,131,177,12,20,22,31,77,207
NOP,Anthony Brown,59,SF,24,9,0,143,14,41,0.341,6,24,0.25,8,17,0.471,0.415,0,0,,6,20,26,6,5,1,5,13,34
NOP,Anthony Davis,100,C,23,75,75,2708,770,1526,0.505,40,134,0.299,730,1392,0.524,0.518,519,647,0.802,172,712,884,157,94,167,181,168,2099
NOP,Archie Goodwin,156,SG,22,3,0,30,2,5,0.4,1,2,0.5,1,3,0.333,0.5,10,10,1.0,0,0,0,1,0,1,0,1,15
NOP,Buddy Hield,192,SG,23,57,37,1161,185,471,0.393,89,241,0.369,96,230,0.417,0.487,29,33,0.879,19,147,166,77,18,7,48,81,488
NOP,Cheick Diallo,109,PF,20,17,0,199,36,76,0.474,0,0,,36,76,0.474,0.474,15,21,0.7140000000000001,23,50,73,4,4,7,7,17,87
NOP,Dante Cunningham,96,PF,29,66,35,1649,174,359,0.485,71,181,0.392,103,178,0.579,0.584,16,27,0.593,56,221,277,37,39,28,28,100,435
NOP,Donatas Motiejunas,313,PF,26,34,0,479,57,138,0.413,11,47,0.234,46,91,0.505,0.453,25,49,0.51,26,75,101,32,18,11,31,55,150
NOP,E'Twaun Moore,309,SG,27,73,22,1820,283,619,0.457,77,208,0.37,206,411,0.501,0.519,57,74,0.77,33,119,152,164,50,32,62,131,700
NOP,Jarrett Jack,216,PG,33,2,0,33,2,3,0.667,0,1,0.0,2,2,1.0,0.667,2,2,1.0,0,0,0,5,2,0,3,4,6
NOP,Jordan Crawford,94,SG,28,19,0,442,105,218,0.482,37,95,0.389,68,123,0.5529999999999999,0.5670000000000001,20,26,0.769,4,30,34,57,11,2,25,30,267
NOP,Jrue Holiday,198,PG,26,67,61,2190,405,893,0.454,100,281,0.35600000000000004,305,612,0.498,0.51,119,168,0.708,46,218,264,488,100,44,194,133,1029
NOP,Lance Stephenson,413,SG,26,6,0,162,26,55,0.473,1,10,0.1,25,45,0.556,0.482,5,8,0.625,3,15,18,29,2,1,11,18,58
NOP,Langston Galloway,143,PG,25,55,0,1120,165,441,0.374,101,268,0.377,64,173,0.37,0.489,40,52,0.769,20,101,121,65,40,5,28,76,471
NOP,Omer Asik,21,C,30,31,19,482,31,65,0.477,0,0,,31,65,0.477,0.477,23,39,0.59,48,115,163,15,5,10,14,51,85
NOP,Reggie Williams,469,SF,30,6,0,79,8,23,0.348,5,11,0.455,3,12,0.25,0.457,6,7,0.857,2,4,6,4,3,0,0,2,27
NOP,Solomon Hill,196,SF,25,80,71,2374,183,478,0.383,94,270,0.348,89,208,0.428,0.481,103,128,0.805,51,256,307,141,72,32,82,182,563
NOP,Terrence Jones,238,PF,25,51,12,1264,231,489,0.472,19,75,0.253,212,414,0.512,0.4920000000000001,103,170,0.606,65,238,303,59,39,53,48,67,584
NOP,Tim Frazier,140,PG,26,65,35,1525,163,404,0.403,40,128,0.313,123,276,0.446,0.453,98,129,0.76,34,139,173,335,56,6,101,133,464
NOP,Tyreke Evans,127,SF,27,26,0,474,91,227,0.401,21,70,0.3,70,157,0.446,0.447,45,58,0.7759999999999999,6,80,86,91,23,4,39,41,248
NOP,Wayne Selden,398,SG,22,3,3,47,5,8,0.625,4,7,0.5710000000000001,1,1,1.0,0.875,2,4,0.5,0,5,5,1,2,0,3,6,16
NYK,Brandon Jennings,224,PG,27,58,11,1428,163,429,0.38,68,200,0.34,95,229,0.415,0.459,102,135,0.7559999999999999,21,131,152,287,55,4,106,84,496
NYK,Carmelo Anthony,17,SF,32,74,74,2538,602,1389,0.433,151,421,0.359,451,968,0.466,0.488,304,365,0.833,62,376,438,213,60,34,153,198,1659
NYK,Courtney Lee,258,SG,31,77,74,2459,321,704,0.456,108,269,0.401,213,435,0.49,0.5329999999999999,85,98,0.867,53,206,259,179,81,24,69,141,835
NYK,Derrick Rose,383,PG,28,64,64,2082,460,977,0.471,13,60,0.217,447,917,0.487,0.477,221,253,0.8740000000000001,66,180,246,283,44,17,147,84,1154
NYK,Joakim Noah,328,C,31,46,46,1015,99,202,0.49,0,1,0.0,99,201,0.493,0.49,34,78,0.436,162,241,403,103,30,37,58,127,232
NYK,Justin Holiday,199,SG,27,82,4,1639,233,538,0.433,97,273,0.355,136,265,0.513,0.523,66,80,0.825,27,198,225,102,65,31,66,109,629
NYK,Kristaps Porzingis,363,PF,21,66,65,2164,443,985,0.45,112,314,0.35700000000000004,331,671,0.493,0.507,198,252,0.7859999999999999,111,364,475,97,47,129,118,244,1196
NYK,Kyle O'Quinn,336,C,26,79,8,1229,215,413,0.521,2,17,0.118,213,396,0.5379999999999999,0.523,64,83,0.7709999999999999,157,282,439,117,36,104,76,174,496
NYK,Lance Thomas,425,PF,28,46,15,968,97,244,0.398,38,85,0.447,59,159,0.371,0.475,43,51,0.843,32,110,142,35,21,5,25,85,275
NYK,Marshall Plumlee,357,C,24,21,1,170,16,30,0.5329999999999999,0,0,,16,30,0.5329999999999999,0.5329999999999999,8,19,0.421,23,28,51,10,4,4,12,23,40
NYK,Maurice Ndour,322,PF,24,32,4,331,39,86,0.453,1,7,0.14300000000000002,38,79,0.481,0.459,19,26,0.731,22,42,64,8,15,8,12,30,98
NYK,Mindaugas Kuzminskas,250,SF,27,68,5,1016,158,369,0.428,54,168,0.321,104,201,0.517,0.501,55,68,0.809,47,79,126,69,29,11,51,79,425
NYK,Ron Baker,24,SG,23,52,13,857,82,217,0.378,23,86,0.267,59,131,0.45,0.431,28,43,0.6509999999999999,12,86,98,107,34,8,56,74,215
NYK,Sasha Vujacic,448,SG,32,42,4,408,42,136,0.309,23,74,0.311,19,62,0.306,0.393,17,24,0.708,12,47,59,52,13,2,16,38,124
NYK,Willy Hernangomez,189,C,22,72,22,1324,246,465,0.529,4,15,0.267,242,450,0.5379999999999999,0.5329999999999999,91,125,0.728,170,332,502,96,41,36,100,150,587
OKC,Alex Abrines,1,SG,23,68,6,1055,134,341,0.393,94,247,0.381,40,94,0.426,0.531,44,49,0.898,18,68,86,40,37,8,33,114,406
OKC,Andre Roberson,377,SF,25,79,79,2376,215,463,0.464,45,184,0.245,170,279,0.609,0.513,47,111,0.423,98,305,403,79,94,79,51,204,522
OKC,Anthony Morrow,312,SG,31,40,7,627,86,223,0.386,35,119,0.294,51,104,0.49,0.464,23,26,0.885,11,18,29,19,22,2,6,40,230
OKC,Cameron Payne,353,PG,22,20,0,320,43,130,0.331,16,52,0.308,27,78,0.34600000000000003,0.392,4,4,1.0,2,29,31,40,10,4,16,38,106
OKC,Domantas Sabonis,390,PF,20,81,66,1632,192,481,0.399,51,159,0.321,141,322,0.438,0.452,44,67,0.657,46,242,288,82,39,32,83,200,479
OKC,Enes Kanter,243,C,24,72,0,1533,402,737,0.545,5,38,0.132,397,699,0.568,0.5489999999999999,224,285,0.7859999999999999,195,287,482,67,32,38,123,154,1033
OKC,Ersan Ilyasova,212,PF,29,3,0,62,6,16,0.375,3,12,0.25,3,4,0.75,0.469,0,0,,2,14,16,1,3,1,4,5,15
OKC,Joffrey Lauvergne,254,PF,25,50,0,739,111,244,0.455,27,78,0.34600000000000003,84,166,0.506,0.51,37,58,0.638,51,132,183,51,18,6,40,71,286
OKC,Josh Huestis,207,PF,25,2,0,31,6,11,0.545,2,4,0.5,4,7,0.5710000000000001,0.636,0,1,0.0,4,5,9,3,0,3,0,0,14
OKC,Kyle Singler,404,SF,28,32,2,385,34,83,0.41,7,37,0.189,27,46,0.5870000000000001,0.452,13,17,0.765,8,40,48,9,7,5,11,29,88
OKC,Nick Collison,86,PF,36,20,0,128,14,23,0.609,0,1,0.0,14,22,0.636,0.609,5,8,0.625,9,22,31,12,2,2,4,17,33
OKC,Norris Cole,84,PG,28,13,0,125,16,52,0.308,3,13,0.231,13,39,0.333,0.337,8,10,0.8,0,11,11,14,8,0,7,18,43
OKC,Russell Westbrook,458,PG,28,81,81,2802,824,1941,0.425,200,583,0.343,624,1358,0.459,0.476,710,840,0.845,137,727,864,840,132,31,438,190,2558
OKC,Semaj Christon,81,PG,24,64,1,973,77,223,0.345,12,63,0.19,65,160,0.406,0.3720000000000001,17,31,0.5479999999999999,19,68,87,130,28,7,43,79,183
OKC,Steven Adams,3,C,23,80,80,2389,374,655,0.5710000000000001,0,1,0.0,374,654,0.5720000000000001,0.5710000000000001,157,257,0.611,281,332,613,86,89,78,146,195,905
OKC,Victor Oladipo,339,SG,24,67,67,2222,412,932,0.442,127,352,0.361,285,580,0.491,0.51,116,154,0.753,39,252,291,176,78,21,119,155,1067
ORL,Aaron Gordon,157,SF,21,80,72,2298,393,865,0.454,77,267,0.28800000000000003,316,598,0.528,0.499,156,217,0.7190000000000001,116,289,405,150,65,40,89,172,1019
ORL,Arinze Onuaku,341,C,29,8,0,28,2,4,0.5,0,0,,2,4,0.5,0.5,0,0,,2,4,6,2,0,1,2,3,4
ORL,Bismack Biyombo,46,C,24,81,27,1793,179,339,0.528,0,0,,179,339,0.528,0.528,125,234,0.534,157,410,567,74,25,91,95,202,483
ORL,C.J. Watson,455,PG,32,62,9,1012,96,248,0.387,32,105,0.305,64,143,0.448,0.452,57,66,0.8640000000000001,16,73,89,114,43,2,47,84,281
ORL,C.J. Wilcox,463,SG,26,22,0,108,8,31,0.258,3,15,0.2,5,16,0.313,0.306,2,2,1.0,4,8,12,12,2,1,6,8,21
ORL,D.J. Augustin,22,PG,29,78,20,1538,195,517,0.377,95,274,0.34700000000000003,100,243,0.412,0.469,131,161,0.8140000000000001,15,102,117,209,31,1,90,101,616
ORL,Damjan Rudez,387,SF,30,45,0,314,31,88,0.35200000000000004,20,64,0.313,11,24,0.458,0.466,0,0,,5,20,25,20,12,1,9,31,82
ORL,Elfrid Payton,354,PG,22,82,58,2412,430,912,0.471,40,146,0.274,390,766,0.509,0.493,146,211,0.6920000000000001,89,298,387,529,88,40,178,177,1046
ORL,Evan Fournier,138,SG,24,68,66,2234,408,930,0.439,128,360,0.35600000000000004,280,570,0.491,0.508,223,277,0.805,44,165,209,202,66,4,141,180,1167
ORL,Jeff Green,167,PF,30,69,11,1534,220,558,0.394,53,193,0.275,167,365,0.458,0.442,145,168,0.863,39,175,214,81,37,13,75,103,638
ORL,Jodie Meeks,298,SG,29,36,10,738,103,256,0.402,56,137,0.409,47,119,0.395,0.512,65,74,0.878,5,72,77,45,34,4,36,41,327
ORL,Marcus Georges-Hunt,151,SG,22,5,0,48,2,7,0.28600000000000003,1,2,0.5,1,5,0.2,0.35700000000000004,9,10,0.9,1,8,9,3,1,0,2,5,14
ORL,Mario Hezonja,190,SF,21,65,2,960,117,330,0.355,43,144,0.299,74,186,0.398,0.42,40,50,0.8,20,126,146,62,30,15,58,74,317
ORL,Nikola Vucevic,447,C,26,75,55,2163,483,1031,0.468,23,75,0.307,460,956,0.481,0.48,107,160,0.669,176,603,779,208,76,74,117,180,1096
ORL,Patricio Garino,144,SG,23,5,0,43,0,7,0.0,0,5,0.0,0,2,0.0,0.0,0,0,,1,6,7,0,0,0,3,4,0
ORL,Serge Ibaka,210,PF,27,56,56,1710,343,703,0.488,83,214,0.388,260,489,0.532,0.547,77,91,0.846,100,282,382,60,34,91,66,139,846
ORL,Stephen Zimmerman,484,C,20,19,0,108,10,31,0.32299999999999995,0,0,,10,31,0.32299999999999995,0.32299999999999995,3,5,0.6,11,24,35,4,2,5,3,17,23
PHI,Alex Poythress,366,PF,23,6,1,157,25,54,0.463,6,19,0.316,19,35,0.5429999999999999,0.519,8,10,0.8,11,18,29,5,3,2,3,14,64
PHI,Chasson Randle,369,PG,23,8,0,74,12,26,0.462,6,15,0.4,6,11,0.545,0.5770000000000001,12,12,1.0,0,5,5,6,3,1,3,11,42
PHI,Dario Saric,392,PF,22,81,36,2129,381,927,0.411,106,341,0.311,275,586,0.469,0.468,172,220,0.782,112,401,513,182,57,30,183,162,1040
PHI,Gerald Henderson,186,SG,29,72,41,1667,234,553,0.423,61,173,0.353,173,380,0.455,0.478,133,165,0.8059999999999999,34,151,185,112,40,15,62,129,662
PHI,Hollis Thompson,426,SG,25,31,1,561,66,159,0.415,26,71,0.366,40,88,0.455,0.4970000000000001,13,20,0.65,15,69,84,26,14,6,9,55,171
PHI,Jahlil Okafor,338,C,21,50,33,1134,242,471,0.514,0,0,,242,471,0.514,0.514,106,158,0.6709999999999999,81,159,240,58,20,49,91,122,590
PHI,Jerami Grant,161,PF,22,2,0,41,6,17,0.353,0,2,0.0,6,15,0.4,0.353,4,8,0.5,0,6,6,0,0,4,3,5,16
PHI,Jerryd Bayless,33,PG,28,3,1,71,11,32,0.344,2,5,0.4,9,27,0.333,0.375,9,10,0.9,3,9,12,13,0,0,9,4,33
PHI,Joel Embiid,124,C,22,31,31,786,200,429,0.466,36,98,0.3670000000000001,164,331,0.495,0.508,191,244,0.7829999999999999,61,182,243,66,27,76,117,112,627
PHI,Justin Harper,174,PF,27,3,0,31,5,12,0.417,2,7,0.28600000000000003,3,5,0.6,0.5,0,0,,2,3,5,2,0,0,4,2,12
PHI,Nerlens Noel,329,C,22,29,7,564,107,175,0.611,0,1,0.0,107,174,0.615,0.611,43,63,0.6829999999999999,46,98,144,30,43,26,29,71,257
PHI,Nik Stauskas,412,SG,23,80,27,2188,251,634,0.396,132,359,0.368,119,275,0.433,0.5,122,150,0.813,21,205,226,188,45,32,128,144,756
PHI,Richaun Holmes,201,C,23,57,17,1193,230,412,0.5579999999999999,27,77,0.35100000000000003,203,335,0.606,0.591,72,103,0.6990000000000001,94,217,311,58,42,55,55,136,559
PHI,Robert Covington,91,SF,26,67,67,2119,292,732,0.399,137,412,0.333,155,320,0.484,0.4920000000000001,143,174,0.8220000000000001,92,344,436,102,127,69,131,203,864
PHI,Sergio Rodriguez,381,PG,30,68,30,1518,210,536,0.392,92,252,0.365,118,284,0.415,0.478,18,27,0.667,21,136,157,344,49,4,128,95,530
PHI,Shawn Long,269,C,24,18,0,234,61,109,0.56,7,19,0.368,54,90,0.6,0.5920000000000001,19,35,0.5429999999999999,41,44,85,13,9,9,13,49,148
PHI,T.J. McConnell,289,PG,24,81,51,2133,236,512,0.461,11,55,0.2,225,457,0.4920000000000001,0.472,73,90,0.8109999999999999,39,212,251,534,134,10,159,139,556
PHI,Tiago Splitter,411,C,32,8,0,76,14,31,0.452,2,6,0.333,12,25,0.48,0.484,9,11,0.818,8,14,22,4,1,1,6,8,39
PHI,Timothe Luwawu-Cabarrot,276,SF,21,69,19,1190,145,361,0.402,50,161,0.311,95,200,0.475,0.471,105,123,0.8540000000000001,25,124,149,75,32,10,73,154,445
PHO,Alan Williams,464,C,24,47,0,708,138,267,0.517,0,1,0.0,138,266,0.519,0.517,70,112,0.625,94,198,292,23,27,32,37,125,346
PHO,Alex Len,260,C,23,77,34,1560,230,463,0.4970000000000001,3,12,0.25,227,451,0.503,0.5,150,208,0.721,156,354,510,44,38,98,102,242,613
PHO,Brandon Knight,247,SG,25,54,5,1140,209,525,0.398,45,139,0.324,164,386,0.425,0.441,132,154,0.857,25,93,118,130,27,5,88,87,595
PHO,Derrick Jones,236,SF,19,32,8,545,68,121,0.562,3,11,0.273,65,110,0.591,0.574,29,41,0.7070000000000001,39,40,79,12,14,13,13,63,168
PHO,Devin Booker,53,SG,20,78,78,2730,606,1431,0.423,147,405,0.363,459,1026,0.447,0.475,367,441,0.8320000000000001,46,203,249,268,72,21,241,242,1726
PHO,Dragan Bender,41,PF,19,43,0,574,57,161,0.354,28,101,0.277,29,60,0.483,0.441,4,11,0.364,23,80,103,23,10,22,32,74,146
PHO,Elijah Millsap,305,SG,29,2,0,23,1,7,0.14300000000000002,0,2,0.0,1,5,0.2,0.14300000000000002,1,2,0.5,3,3,6,1,0,0,2,2,3
PHO,Eric Bledsoe,49,PG,27,66,66,2176,449,1034,0.434,104,310,0.335,345,724,0.477,0.485,388,458,0.847,52,268,320,418,91,31,224,164,1390
PHO,Jared Dudley,116,PF,31,64,7,1362,157,346,0.454,77,203,0.379,80,143,0.5589999999999999,0.565,43,65,0.662,31,194,225,121,42,16,73,154,434
PHO,Jarell Eddie,120,SF,25,5,0,62,6,19,0.316,4,16,0.25,2,3,0.667,0.421,8,9,0.889,1,6,7,0,1,0,1,1,24
PHO,John Jenkins,223,SG,25,4,0,13,2,5,0.4,1,2,0.5,1,3,0.333,0.5,2,2,1.0,0,1,1,1,0,0,0,0,7
PHO,Leandro Barbosa,26,SG,34,67,0,963,172,392,0.439,35,98,0.35700000000000004,137,294,0.466,0.483,40,45,0.889,15,89,104,81,31,8,48,82,419
PHO,Marquese Chriss,79,PF,19,82,75,1743,284,632,0.449,72,224,0.321,212,408,0.52,0.506,113,181,0.624,96,252,348,60,67,70,108,263,753
PHO,P.J. Tucker,434,SF,31,57,17,1627,147,354,0.415,46,136,0.338,101,218,0.463,0.48,61,77,0.792,94,248,342,73,85,14,52,143,401
PHO,Ronnie Price,367,PG,33,14,0,134,4,24,0.16699999999999998,3,17,0.17600000000000002,1,7,0.14300000000000002,0.229,3,4,0.75,3,8,11,18,11,1,3,14,14
PHO,T.J. Warren,454,SF,23,66,59,2048,403,814,0.495,26,98,0.265,377,716,0.527,0.511,119,154,0.773,125,214,339,75,76,39,57,175,951
PHO,Tyler Ulis,438,PG,21,61,15,1123,184,437,0.421,21,79,0.266,163,358,0.455,0.445,55,71,0.775,20,75,95,226,48,5,77,73,444
PHO,Tyson Chandler,77,C,34,47,46,1298,153,228,0.6709999999999999,0,0,,153,228,0.6709999999999999,0.6709999999999999,91,124,0.7340000000000001,153,386,539,30,33,24,65,126,397
POR,Al-Farouq Aminu,10,PF,26,61,25,1773,183,466,0.393,70,212,0.33,113,254,0.445,0.468,96,136,0.706,77,374,451,99,60,44,94,102,532
POR,Allen Crabbe,92,SG,24,79,7,2254,303,647,0.468,134,302,0.444,169,345,0.49,0.5720000000000001,105,124,0.847,19,207,226,94,54,20,62,171,845
POR,C.J. McCollum,288,SG,25,80,80,2796,692,1441,0.48,185,439,0.421,507,1002,0.506,0.544,268,294,0.912,60,229,289,285,72,42,172,202,1837
POR,Damian Lillard,266,PG,26,75,75,2694,661,1488,0.444,214,579,0.37,447,909,0.4920000000000001,0.516,488,545,0.895,46,322,368,440,68,20,197,152,2024
POR,Ed Davis,102,PF,27,46,12,789,75,142,0.528,0,0,,75,142,0.528,0.528,50,81,0.617,96,148,244,26,15,22,37,137,200
POR,Evan Turner,435,SF,28,65,12,1658,235,552,0.426,31,118,0.263,204,434,0.47,0.454,85,103,0.825,36,211,247,205,53,24,100,121,586
POR,Jake Layman,257,SF,22,35,1,249,26,89,0.292,13,51,0.255,13,38,0.342,0.365,13,17,0.765,6,18,24,11,9,3,11,22,78
POR,Mason Plumlee,358,C,26,54,54,1516,235,442,0.532,0,5,0.0,235,437,0.5379999999999999,0.532,127,224,0.5670000000000001,120,312,432,214,50,63,88,149,597
POR,Maurice Harkless,173,SF,23,77,69,2223,314,624,0.503,68,194,0.35100000000000003,246,430,0.5720000000000001,0.5579999999999999,77,124,0.621,125,216,341,88,85,70,86,214,773
POR,Meyers Leonard,262,PF,24,74,12,1222,146,378,0.386,74,213,0.34700000000000003,72,165,0.436,0.484,35,40,0.875,27,210,237,71,13,28,35,172,401
POR,Noah Vonleh,446,PF,21,74,41,1265,130,270,0.481,7,20,0.35,123,250,0.4920000000000001,0.494,60,94,0.638,131,256,387,31,30,27,64,154,327
POR,Pat Connaughton,88,SG,24,39,1,316,37,72,0.514,17,33,0.515,20,39,0.513,0.632,7,9,0.778,10,42,52,28,6,2,17,23,98
POR,Shabazz Napier,321,PG,25,53,2,512,73,183,0.399,34,92,0.37,39,91,0.429,0.4920000000000001,38,49,0.7759999999999999,8,53,61,67,32,2,41,38,218
POR,Tim Quarterman,368,SG,22,16,0,80,13,29,0.448,5,13,0.385,8,16,0.5,0.534,0,3,0.0,4,10,14,11,2,3,11,6,31
SAC,Anthony Tolliver,431,PF,31,65,9,1477,155,351,0.442,90,230,0.391,65,121,0.537,0.57,61,82,0.7440000000000001,51,186,237,77,34,20,56,109,461
SAC,Arron Afflalo,4,SG,31,61,45,1580,185,420,0.44,62,151,0.411,123,269,0.457,0.514,83,93,0.892,9,116,125,78,21,6,42,104,515
SAC,Ben McLemore,295,SG,23,61,26,1176,180,419,0.43,65,170,0.382,115,249,0.462,0.507,70,93,0.753,19,110,129,51,29,6,62,108,495
SAC,Darren Collison,85,PG,29,68,64,2063,340,714,0.476,73,175,0.417,267,539,0.495,0.527,147,171,0.86,23,129,152,312,67,9,114,119,900
SAC,DeMarcus Cousins,90,C,26,55,55,1891,505,1118,0.452,95,267,0.35600000000000004,410,851,0.482,0.494,423,549,0.77,115,468,583,266,75,74,207,203,1528
SAC,Garrett Temple,422,SG,30,65,21,1728,183,432,0.424,82,220,0.373,101,212,0.476,0.519,58,74,0.784,32,152,184,168,84,28,78,141,506
SAC,Georgios Papagiannis,345,C,19,22,0,355,56,102,0.5489999999999999,0,2,0.0,56,100,0.56,0.5489999999999999,12,14,0.857,24,62,86,20,3,17,24,44,124
SAC,Jordan Farmar,130,PG,30,2,0,35,4,12,0.333,4,9,0.444,0,3,0.0,0.5,0,0,,1,2,3,9,2,0,3,1,12
SAC,Kosta Koufos,249,C,27,71,62,1419,216,392,0.551,0,1,0.0,216,391,0.552,0.551,38,62,0.613,118,285,403,47,36,48,61,172,470
SAC,Malachi Richardson,375,SG,21,22,0,198,28,68,0.412,8,28,0.28600000000000003,20,40,0.5,0.471,15,19,0.789,3,20,23,11,5,1,8,23,79
SAC,Matt Barnes,29,SF,36,54,13,1367,147,383,0.384,69,211,0.327,78,172,0.453,0.474,50,66,0.758,55,238,293,150,36,17,83,138,413
SAC,Omri Casspi,75,PF,28,22,2,397,53,117,0.453,11,29,0.379,42,88,0.477,0.5,12,21,0.5710000000000001,20,70,90,26,10,1,17,23,129
SAC,Rudy Gay,147,SF,30,30,30,1013,201,442,0.455,42,113,0.3720000000000001,159,329,0.483,0.502,118,138,0.855,35,155,190,83,44,26,74,79,562
SAC,Skal Labissiere,251,PF,20,33,12,612,117,218,0.537,3,8,0.375,114,210,0.5429999999999999,0.544,52,74,0.703,51,111,162,27,16,13,37,64,289
SAC,Ty Lawson,256,PG,29,69,24,1732,237,522,0.454,34,118,0.28800000000000003,203,404,0.502,0.487,173,217,0.797,44,135,179,334,74,6,129,119,681
SAC,Willie Cauley-Stein,76,C,23,75,21,1421,255,481,0.53,0,2,0.0,255,479,0.532,0.53,101,151,0.669,85,254,339,80,53,44,69,147,611
SAS,Bryn Forbes,137,SG,23,36,0,285,36,99,0.364,17,53,0.321,19,46,0.413,0.449,5,6,0.833,2,21,23,23,1,0,11,20,94
SAS,Danny Green,163,SG,29,68,68,1807,176,449,0.392,118,311,0.379,58,138,0.42,0.523,27,32,0.8440000000000001,31,193,224,124,70,57,76,120,497
SAS,David Lee,259,PF,33,79,10,1477,248,420,0.59,0,0,,248,420,0.59,0.59,80,113,0.708,149,292,441,124,31,40,82,125,576
SAS,Davis Bertans,44,PF,24,67,6,808,103,234,0.44,69,173,0.399,34,61,0.557,0.588,28,34,0.8240000000000001,22,76,98,46,20,28,32,75,303
SAS,Dejounte Murray,317,PG,20,38,8,322,50,116,0.431,9,23,0.391,41,93,0.441,0.47,21,30,0.7,6,36,42,48,8,6,38,29,130
SAS,Dewayne Dedmon,103,C,27,76,37,1330,161,259,0.622,0,0,,161,259,0.622,0.622,65,93,0.6990000000000001,129,367,496,44,37,61,61,180,387
SAS,Joel Anthony,18,C,34,19,0,122,10,16,0.625,0,0,,10,16,0.625,0.625,5,8,0.625,8,23,31,3,2,6,4,11,25
SAS,Jonathon Simmons,403,SG,27,78,8,1392,177,421,0.42,30,102,0.294,147,319,0.461,0.456,99,132,0.75,20,140,160,126,47,25,76,146,483
SAS,Kawhi Leonard,261,SF,25,74,74,2474,636,1312,0.485,147,387,0.38,489,925,0.529,0.541,469,533,0.88,80,350,430,260,133,55,154,122,1888
SAS,Kyle Anderson,14,SF,23,72,14,1020,93,209,0.445,15,40,0.375,78,169,0.462,0.481,45,57,0.789,33,175,208,91,51,26,39,63,246
SAS,LaMarcus Aldridge,7,PF,31,72,72,2335,500,1049,0.477,23,56,0.411,477,993,0.48,0.488,220,271,0.812,172,351,523,139,46,88,98,158,1243
SAS,Manu Ginobili,154,SG,39,69,0,1291,171,439,0.39,89,227,0.392,82,212,0.387,0.491,86,107,0.804,28,129,157,183,82,16,96,119,517
SAS,Nicolas Laprovittola,253,PG,27,18,3,174,20,47,0.426,10,27,0.37,10,20,0.5,0.532,9,9,1.0,1,9,10,28,4,1,19,19,59
SAS,Patty Mills,304,PG,28,80,8,1754,273,621,0.44,147,355,0.414,126,266,0.474,0.5579999999999999,66,80,0.825,24,117,141,280,65,3,101,109,759
SAS,Pau Gasol,146,C,36,64,39,1627,303,604,0.502,56,104,0.5379999999999999,247,500,0.494,0.5479999999999999,130,184,0.7070000000000001,107,394,501,150,24,70,81,110,792
SAS,Tony Parker,347,PG,34,63,63,1587,265,569,0.466,23,69,0.333,242,500,0.484,0.486,85,117,0.726,9,104,113,285,34,2,89,92,638
TOR,Bruno Caboclo,67,SF,21,9,0,40,6,16,0.375,2,6,0.333,4,10,0.4,0.438,0,0,,5,5,10,4,2,1,2,4,14
TOR,Cory Joseph,241,PG,25,80,22,2003,299,661,0.452,48,135,0.35600000000000004,251,526,0.477,0.489,94,122,0.77,51,184,235,265,66,13,108,140,740
TOR,DeMar DeRozan,108,SG,27,74,74,2620,721,1545,0.467,33,124,0.266,688,1421,0.484,0.477,545,647,0.8420000000000001,70,316,386,290,78,13,180,134,2020
TOR,DeMarre Carroll,72,SF,30,72,72,1882,220,550,0.4,109,320,0.341,111,230,0.483,0.499,89,117,0.7609999999999999,63,212,275,74,81,27,54,143,638
TOR,Delon Wright,477,PG,24,27,0,446,49,116,0.422,10,30,0.333,39,86,0.453,0.466,42,55,0.764,16,32,48,57,27,11,25,31,150
TOR,Fred VanVleet,442,PG,22,37,0,294,39,111,0.35100000000000003,11,29,0.379,28,82,0.341,0.401,18,22,0.818,4,38,42,35,16,3,15,36,107
TOR,Jakob Poeltl,360,C,21,54,4,626,67,115,0.583,0,0,,67,115,0.583,0.583,31,57,0.544,78,87,165,12,17,20,29,113,165
TOR,Jared Sullinger,417,PF,24,11,1,118,15,47,0.319,3,18,0.16699999999999998,12,29,0.414,0.35100000000000003,4,8,0.5,10,17,27,3,4,1,4,17,37
TOR,Jonas Valanciunas,440,C,24,80,80,2066,391,702,0.557,1,2,0.5,390,700,0.557,0.5579999999999999,176,217,0.8109999999999999,226,533,759,57,37,63,106,216,959
TOR,Kyle Lowry,274,PG,30,60,60,2244,426,918,0.464,193,468,0.412,233,450,0.518,0.569,299,365,0.8190000000000001,48,238,286,417,88,19,173,170,1344
TOR,Lucas Nogueira,330,C,24,57,6,1088,103,156,0.66,3,12,0.25,100,144,0.6940000000000001,0.67,44,67,0.657,82,162,244,42,52,89,46,137,253
TOR,Norman Powell,365,SG,23,76,18,1368,227,506,0.449,56,173,0.324,171,333,0.514,0.504,126,159,0.792,26,143,169,82,52,14,70,127,636
TOR,Pascal Siakam,402,PF,22,55,38,859,103,205,0.502,1,7,0.14300000000000002,102,198,0.515,0.505,22,32,0.688,64,121,185,17,26,45,33,109,229
TOR,Patrick Patterson,350,PF,27,65,8,1599,154,384,0.401,94,253,0.3720000000000001,60,131,0.458,0.523,43,60,0.7170000000000001,62,231,293,76,40,23,38,120,445
TOR,Terrence Ross,384,SF,25,54,0,1207,211,479,0.441,96,256,0.375,115,223,0.516,0.541,41,50,0.82,14,124,138,45,53,20,33,82,559
UTA,Alec Burks,65,SG,25,42,0,653,99,248,0.399,25,76,0.329,74,172,0.43,0.45,60,78,0.769,17,103,120,30,18,5,35,50,283
UTA,Boris Diaw,110,PF,34,73,33,1283,146,327,0.446,20,81,0.247,126,246,0.512,0.477,26,35,0.743,46,112,158,170,18,9,87,83,338
UTA,Dante Exum,128,PG,21,66,26,1228,155,363,0.4270000000000001,44,149,0.295,111,214,0.519,0.488,58,73,0.795,30,102,132,111,21,12,80,146,412
UTA,Derrick Favors,131,PF,25,50,39,1186,203,417,0.487,3,10,0.3,200,407,0.491,0.49,67,109,0.615,92,213,305,56,45,40,60,103,476
UTA,George Hill,194,PG,30,49,49,1544,289,606,0.477,94,233,0.403,195,373,0.523,0.5539999999999999,157,196,0.8009999999999999,23,144,167,204,50,11,85,114,829
UTA,Gordon Hayward,185,SF,26,73,73,2516,545,1156,0.471,149,374,0.398,396,782,0.506,0.536,362,429,0.8440000000000001,49,345,394,252,73,20,140,117,1601
UTA,Jeff Withey,473,C,26,51,1,432,55,103,0.534,0,1,0.0,55,102,0.539,0.534,36,48,0.75,52,69,121,7,16,32,14,52,146
UTA,Joe Ingles,213,SF,29,82,26,1972,204,451,0.452,123,279,0.441,81,172,0.471,0.589,50,68,0.735,23,238,261,225,96,8,107,163,581
UTA,Joe Johnson,229,SF,35,78,14,1843,273,626,0.436,106,258,0.411,167,368,0.454,0.521,63,77,0.818,33,210,243,144,36,18,69,93,715
UTA,Joel Bolomboy,52,PF,23,12,0,53,9,16,0.563,1,4,0.25,8,12,0.667,0.594,3,6,0.5,4,13,17,2,1,2,2,1,22
UTA,Raul Neto,325,PG,24,40,0,346,41,91,0.451,10,31,0.32299999999999995,31,60,0.517,0.505,8,9,0.889,4,26,30,34,21,5,15,48,100
UTA,Rodney Hood,202,SG,24,59,55,1593,272,666,0.408,114,307,0.371,158,359,0.44,0.494,90,115,0.7829999999999999,16,186,202,96,38,11,65,132,748
UTA,Rudy Gobert,155,C,24,81,81,2744,413,625,0.6609999999999999,0,1,0.0,413,624,0.662,0.6609999999999999,311,476,0.653,314,721,1035,97,49,214,147,246,1137
UTA,Shelvin Mack,279,PG,26,55,9,1205,170,381,0.446,37,120,0.308,133,261,0.51,0.495,53,77,0.688,20,105,125,154,42,3,90,100,430
UTA,Trey Lyles,277,PF,21,71,4,1158,159,439,0.362,65,204,0.319,94,235,0.4,0.436,57,79,0.722,48,187,235,69,26,20,64,97,440
WAS,Andrew Nicholson,327,PF,27,28,0,231,30,77,0.39,3,16,0.188,27,61,0.443,0.409,7,12,0.583,11,23,34,7,11,6,11,37,70
WAS,Bradley Beal,36,SG,23,77,77,2684,637,1322,0.482,223,552,0.404,414,770,0.5379999999999999,0.5660000000000001,282,342,0.825,53,187,240,267,83,21,156,169,1779
WAS,Daniel Ochefu,337,C,23,19,0,75,12,27,0.444,0,0,,12,27,0.444,0.444,0,2,0.0,5,17,22,3,2,0,3,17,24
WAS,Danuel House,204,SG,23,1,0,1,0,0,,0,0,,0,0,,,0,0,,0,1,1,0,0,0,0,0,0
WAS,Ian Mahinmi,280,C,30,31,0,555,65,111,0.586,0,0,,65,111,0.586,0.586,43,75,0.573,47,103,150,19,33,24,34,90,173
WAS,Jason Smith,408,C,30,74,3,1068,174,329,0.529,37,78,0.474,137,251,0.546,0.585,35,51,0.6859999999999999,64,194,258,37,21,54,58,168,420
WAS,John Wall,452,PG,26,78,78,2836,647,1435,0.451,89,272,0.327,558,1163,0.48,0.482,422,527,0.8009999999999999,59,267,326,831,157,49,322,151,1805
WAS,Kelly Oubre,343,SF,21,79,5,1605,186,442,0.421,54,188,0.287,132,254,0.52,0.482,75,99,0.758,61,200,261,47,58,17,50,195,501
WAS,Marcin Gortat,159,C,32,82,82,2556,390,674,0.579,0,2,0.0,390,672,0.58,0.579,103,159,0.648,238,611,849,121,40,61,119,213,883
WAS,Marcus Thornton,429,SG,29,33,1,575,84,210,0.4,28,80,0.35,56,130,0.431,0.467,23,27,0.852,22,54,76,41,19,3,25,48,219
WAS,Markieff Morris,311,PF,27,76,76,2374,406,889,0.457,71,196,0.362,335,693,0.483,0.4970000000000001,180,215,0.8370000000000001,107,386,493,126,82,42,129,254,1063
WAS,Otto Porter,361,SF,23,80,80,2605,414,803,0.516,148,341,0.434,266,462,0.5760000000000001,0.608,99,119,0.8320000000000001,118,396,514,121,116,42,44,193,1075
WAS,Sheldon Mac,278,SG,24,30,3,287,30,75,0.4,7,30,0.233,23,45,0.511,0.447,23,27,0.852,4,30,34,15,8,2,5,17,90
WAS,Tomas Satoransky,393,SG,25,57,3,719,61,147,0.415,9,37,0.243,52,110,0.473,0.446,23,33,0.6970000000000001,25,58,83,92,26,6,38,60,154
WAS,Trey Burke,64,PG,24,57,0,703,116,255,0.455,31,70,0.443,85,185,0.459,0.516,22,29,0.759,7,40,47,100,11,5,48,54,285
